
#        =
         =
   =     =
   =     =
^  =     =
==~=~==  =
==~=~==  =
==~=~==  =
==~~~==  =
==========
