          
          
 /---=---/
          
^        #
=~~~===~==
=~~~~~~~==
==========
==========
==========
