         2
 =========
 /---=---/
          
^        2
=~~~===~==
=~~~~~~~==
==========
==========
==========
